11111111111111
10000000000001
10033300000001
100222P0000001
100C0000000001
11111111111111