1111111111111111111111111111
1P0000000000CC00000000000001
1000000000000000000000000001
1000000000000000000000000E01
1000000000000000000000000001
1000000000000000000000000001
1111111111111111111111111111