1111111111111
10010000000C1
1C0P011111101
1C00CCE000001
1111111111111