1111111111111
10010000000C1
1000011111001
1C0011E000001
1110111111111
10000000000C1
1000011111001
1CP0110000001
1111111111111