1111111111111
10010000000C1
100N011111001
1CN011E000001
1110111111111
10N00000000C1
1000011111001
1CP0110000001
1111111111111